2 13 31
###############################
#p  x                         #
#***          #*****          #
# #           #               #
#*s           #               #
#*s           #               #
#      ###############        #
#             #               #
#             #               #
#      f      #               #
#    *****    #               #
#                             #
###############################